tvns: pgtl - hmql
vpsv: cscd / gtjw
pwzw: tfwt / nbts
ghqf: hlzm - rscb
rnwh: humn - qpdw
fchh: nhsb + pwzw
qqmq: dbjv + qssh
sfbw: nwls - vfbg
jjrv: lbzh * wtrd
tfwt: bpjz - sllm
root: wgbd == rqsg
gmrn: lvsj / gqsn
nrrg: gzhp / pqtz
qczc: dnfz / wphb
djjh: fptm + hzhb
pfjn: phlr + nmhb
hlzm: djjh * mdpq
tnwl: qldz / lswd
chvf: bmbl * cnmh
gwbm: rjqb + vgzf
lfnl: bgcm - hwnf
phlr: jvjf * mnzf
crzb: tpsg / rsdz
vgzf: gqll + sczl
lsdp: vcsv / bzmt
wpdw: cgsq + lntd
fptm: ncpr / jmmb
sczl: rnwh * vjlb
lvsj: mcgh - hgrq
nllv: bqfz / mftt
nwls: pqbg * ncfh
gzhp: nwdc - vrst
srmf: crzb + nspz
zzjv: njsq * dvcl
lntd: jjrv - dscg
fzpc: sfbw + srbr
thnr: lsdp + mcwt
bmmm: nfqq * lmfz
lbbc: zmjt + wqhn
mcgh: thnr * fhjr
pqbg: mdfn + qczc
jlgg: qqmq / cbjz
qrfq: vpsv + smct
pgtl: fchh / tzrf
zlsr: chvf - wrbn
mplm: tnwl + qfbm
wtrd: lcjn + jlgg
tpsg: tzdt - dvrg
dvcl: nrrg + wrqq
dbjv: qfwp * dmbc
cnmh: bfpz + zblh
dmbc: bmmm - lbtz
mqqw: wgrw * ghqf
tzdt: wpdw / zmpt
dnfz: pcml - dhvq
ncpr: jrvd - qwbz
qldz: wctr - gmrn
cscd: zlsr + qqvc
bgcm: gldw / dgrv
qgmj: lbbc / nzjc
jvjf: nllv - cfjh
zblh: gwbm / fnhh
vcsv: hfjf + mqqw
wgbd: cdfc * mplm
bpjz: pfjn * whlb
pcml: bvdf * lfnl
lmfz: qgmj + cjsd
wqhn: fzpc + hwqs
jrvd: srmf * qnzm
bqfz: qpvl + qrfq
gldw: jltd + zzjv
nwdc: tvns * rfwd
humn: 0